{
    "Floor_1": {
        "Left_wing": {
            "102": 3,
            "103": 3,
            "104": 3,
            "105": 3,
            "106": 3,
            "124": 3,
            "125": 3
        },
        "Right_wing": {
            "112": 3,
            "113": 3,
            "114": 3,
            "115": 3,
            "116": 3,
            "117": 3,
            "118": 3,
            "119": 3
        }
    },
    "Floor_2": {
        "Left_wing": {
            "201": 3,
            "202": 2,
            "203": 3,
            "204": 3,
            "205": 3,
            "206": 3,
            "207": 3,
            "208": 3,
            "209": 2, 
            "221": 3,
            "222": 3,
            "223": 3,
            "224": 3,
            "225": 3
        },
        "Right_wing": {
            "210": 3,
            "211": 3,
            "212": 3,
            "213": 3,
            "214": 3,
            "215": 3,
            "216": 3,
            "217": 3,
            "218": 1,
            "219": 3,
            "220": 3
        }
    },
    "Floor_3": {
        "Left_wing": {
            "301": 3,
            "302": 3,
            "303": 3,
            "304": 3,
            "305": 1,
            "306": 3,
            "307": 3,
            "308": 3,
            "309": 3,
            "321": 3,
            "322": 3,
            "323": 3,
            "324": 3,
            "325": 3
        },
        "Right_wing": {
            "310": 3,
            "311": 3,
            "312": 3,
            "313": 1,
            "314": 1,
            "315": 3,
            "316": 3,
            "317": 3,
            "318": 3,
            "319": 3,
            "320": 3
        }
    },
    "Floor_4": {
        "Left_wing": {
            "401": 3,
            "402": 3,
            "403": 3,
            "404": 3,
            "405": 3,
            "406": 3,
            "407": 3,
            "408": 3,
            "409": 3,
            "421": 3,
            "422": 3,
            "423": 3,
            "424": 3,
            "425": 3
        },
        "Right_wing": {
            "410": 3,
            "411": 3,
            "412": 3,
            "413": 3,
            "414": 3,
            "415": 3,
            "416": 3,
            "417": 3,
            "418": 3,
            "419": 3,
            "420": 3
        }
    },
    "Floor_5": {
        "Left_wing": {
            "501": 3,
            "502": 3,
            "503": 3,
            "504": 3,
            "505": 3,
            "506": 3,
            "507": 3,
            "508": 3,
            "509": 3,
            "521": 3,
            "522": 3,
            "523": 3,
            "524": 3,
            "525": 3
        },
        "Right_wing": {
            "510": 3,
            "511": 3,
            "512": 3,
            "513": 3,
            "514": 3,
            "515": 3,
            "516": 3,
            "517": 3,
            "518": 3,
            "519": 3,
            "520": 3
        }
    }
}